########################################
#\.=...................................#
# ######################################
# ...=.................................#
# ######################################
# .....=...............................#
# ######################################
# .......=.............................#
# ######################################
# .........=...........................#
# ######################################
# ...........=.........................#
# ######################################
# .............=.......................#
# ######################################
# ...............=.....................#
# ######################################
# ................=....................#
# ######################################
# ................v.=..................#
# ######################################
# ...................=.................#
# ######################################
# ....................=................#
# ######################################
# .....................=...............#
# ######################################
# .......................=.............#
# ######################################
# ........................=............#
# ######################################
# .........................=...........#
# ######################################
# ..........................=..........#
# ######################################
# oooooooooooooooooooooooooooooooooooo%#
########################################